Contracts over six months are allowed, only list jobs you've had since attending PS.
Released under CC-0.

Alex Lee: Yahoo! -> GCap -> Kneedl -> Smarkets -> Freelance
Aquarion: Trutap -> Skimlinks -> Languagelab -> Zappit -> JeemTV -> Skute -> Siftware -> Elsevier
Ben Marvell: Wiley -> Sky -> LexisNexis -> Centrica -> GDS -> Freelance
Dan W: Watershed -> Makeshift -> Freelance -> BuckleyWilliams
Dan Webb: Vivabit -> peoplesmusicstore -> Twitter -> Deliveroo
David R. MacIver: Trampoline -> Aframe -> Lumi -> Google -> Freelance
Felix Hawkins: DigiResults -> NAP -> Lonely Planet
Jake Archibald: BBC -> theTeam -> Lanyrd -> Google
James Aitken: HostGator -> UK2
Leon: The Trainline -> Trafalgar -> CRU -> 7Digital
Meri Williams: GDS -> Vodafone -> myHealthPal -> M&S -> Moo
Mike Stenhouse: Trampoline -> Aframe
MikeD:  Yahoo! -> LOVEFiLM -> Tizaro -> InstaSupply
Nicky: MOO -> Freelance -> FutureLearn -> Freelance -> FutureLearn
abscond: Freelance -> citysafe -> peoplesmusicstore -> Freelance -> Unboxed -> BERG -> Freelance -> MOJ -> GDS -> MOJ -> Labour Party -> ?
actel: CRU -> Freelance -> RBI
adamamyl: mySociety -> TooManyHats -> Guardian -> RewiredState -> OKFN
alexs: QuietRevolution -> Artfinder -> Green Man Gaming -> Quru -> Freelance -> Lyst
alfeaton: Nature -> Mendeley -> PeerJ
alicebartlett: Assanka -> BERG -> GDS -> FT
andrewgodwin: Torchbox -> Epio -> Lanyrd -> Eventbrite
andyhume: Multimap -> Microsoft -> Clearleft -> Guardian -> Twitter
ashb: Fotango -> NAP -> DigiResults -> Freelance -> MOJ -> Crowdmix -> M&S
benward: Fujitsu Siemens -> Yobject -> Yahoo! -> Yahoo! US -> Twitter
bfirsh: GCap -> Guardian -> Epio -> Lanyrd -> This Is My Jam -> Poetica -> GDS -> Orchard -> Docker -> ?
rossbruniges: LSBU -> GCap -> LBi -> Nature -> Mozilla -> Expedia -> M&S
bradwright: Yahoo! -> GCap -> Smarkets -> GDS -> M&S -> StreetTeam
bruntonspall: Guardian -> GDS
cackhanded: Yahoo! -> Linden Lab -> Artfinder -> GDS -> myHealthPal -> M&S -> LiveStax -> Money Advice Service
cbetta: Nudge -> MinuteBox -> EmberAds -> PayPal -> Freelance
chrismear: Freelance -> Greenvoice -> Freelance -> Litmus
czetter: Reevoo -> Rentify -> FutureLearn
creature: Sun Microsystems -> Framestore CFC -> Last.fm -> 500px
dannyamey: Yahoo! -> Grand Union -> Synacor -> Preloaded -> Tobias & Tobias -> Contentment -> Yammer -> Deliveroo
dexterperrin: marketpipe -> BBC -> LOVEFiLM -> Amazon
dom: icom -> Freelance -> LBi -> Freelance -> DigiResults -> Freelance -> Unboxed -> GDS -> NHS -> M&S -> ?
dominicgs: Geneity -> Fluent Image -> ITG -> Great Scott Gadgets
dorward: Fish IC -> Sophos -> Yahoo! -> Playfire -> BBC -> Base79 -> Razorfish -> FairFX
dsingleton: Spring Digital -> Last.fm -> Lumi -> GDS
dunk: Last.fm -> Academia -> Genomics England
eadmundo: Yahoo! -> Squiz -> Smarkets -> Tobias & Tobias -> Adaptive Lab
elliz: Soundmouse -> BritMilFit -> Microsoft -> Solidsoft -> SSE
fatbusinessman: Taptu -> Glasses Direct -> Mozilla -> GDS -> FutureLearn -> Hypothes.is
garethr: GCap -> Glasses Direct -> FreeAgent -> GDS -> Puppet Labs
georgebrock: Freelance -> Reevoo -> Artfinder -> Tripbirds -> Freelance -> thoughtbot
ginader: Yahoo! -> Yahoo! US -> Google
hadleybeeman: LinkedGov -> Technology Strategy Board -> Mozilla -> GDS -> ?
imranghory: Freelance -> Index Ventures -> MarketInvoice
jabley: GDS -> M&S -> Moo
jaylett: tangozebra -> Kudocities -> Freelance -> EMI -> Artfinder -> NSFWCORP -> Freelance
jonty: Last.fm -> Lumi -> IRCCloud -> GDS
jordan: GDS -> Australian DTO
jwheare: Torchbox -> Last.fm -> IRCCloud
kapowaz: Teamphone -> HomeAway -> VideoJuicer -> Unboxed -> Photobox -> Bloomcrush -> Deliveroo
kevinprince: Capita -> World Food Programme -> NBC Universal -> O2 -> Guestfolio
knockles: Red Snapper -> Squiz -> Yahoo! -> Expedia
lindas: Last.fm -> Code Club -> Knight-Mozilla fellowship -> Freelance
lizard: icom -> Unboxed -> Sky
lucas42: Assanka -> FT
lucky: Fabric -> 1000Heads -> Freelance -> Hogarth -> Fabric -> Freelance -> Wunderman -> RAPP -> Maxus
matthias: recollective -> Less Rain -> Freelance -> Design Science Office -> Photobox
mikeb: siteDoc -> cloudMap -> calcResult
mnowster: tangozebra -> Acknowledge -> Glasses Direct -> Artfinder -> GDS -> Freelance -> LiveStax
mokele: Last.fm -> Smarkets -> Stroud Brewery -> Actual Experience
ms7821: Geneity
mseckington: EmberAds -> Unboxed -> FutureLearn
muffinresearch: Multimap -> Yahoo! -> GCap -> Canonical -> Mozilla
muz: Last.fm -> Mendeley -> BBC -> blinkbox -> idio
natbat: Torchbox -> Clearleft -> Lanyrd -> Eventbrite -> ?
neilcrosby: Yahoo!  -> BBC -> LOVEFiLM -> Amazon -> Tizaro -> InstaSupply
paulcuth: ATS -> Gamesys -> Synthace
pete goodman: Tonic -> Pirata -> f90
phae: Volume -> BBC -> Nature -> GDS -> Code for America -> Freelance
pkqk: Reevoo -> Artfinder -> BERG -> myHealthPal -> ODI -> Freelance -> Farmdrop
poppiestar: adsdotcom -> Gamesys -> TravelMatch -> Lonely Planet -> Freelance -> Tesco
retallicka: Mediatonic -> Adjust Your Set -> Gamesys -> ?
rnalexander: youDevise -> TIMGroup -> Money Advice Service
RJ: Last.fm -> IRCCloud
Richard Pope: MOO -> mySociety -> Freelance -> GDS -> ?
Rowan: Assanka -> FT
rboulton: Lemur Consulting -> Celestial Navigation -> Lumi -> GDS
russss: Last.fm -> Smarkets -> IRCCloud -> Freelance
SamLR: carhoots -> plentific -> ZenithOptimedia -> GDS
Sarah Clark: icom -> Steely Eye -> Isobar -> Freelance
skarab: Smarkets -> G-Research
simonw: Yahoo! -> GCap -> Guardian -> Lanyrd -> Eventbrite
slightlyoff: Google
solidgoldpig:Freelance -> Symbian Foundation -> Maersk -> Freelance -> MOJ
Steve Marshall: Fujitsu Siemens -> Yahoo! -> Expedia -> Tizaro -> MOJ
skr: Last.fm -> Twitter -> Fig.co
Sully: Academia
tef: Code Club -> Citymapper -> Heroku -> ?
theartisan: uSwitch Communications -> Top10.com -> PeerIndex -> BrightTalk -> Fabric -> Freelance -> Havas Helia -> GDS
tmower: GDS
tommorris: Academia -> Colourfast -> LinkedGov -> Fabric -> M&S -> Freelance
tommypalm: GDS -> Deliveroo
tomscott: tomscott -> tomscott -> Trinity Mirror -> tomscott
Tamsin: Yahoo! -> MOO
vetraskr: Baker Tilly -> ZenithOptimedia
voodoochild: Squiz -> Tobias & Tobias -> Guardian -> Expedia
YaaL: MOO -> Beam.tv -> UK2 -> Contentment -> EVRYTHNG
yahnyinlondon: Yahoo! -> RMA Consulting -> Freelance

